coach,team,seas_num_fr,seas_num_ovr,games,wins,losses,fr_g,fr_w,fr_l,car_g,car_w,car_l,car_w_pct,p_g,p_w,p_l,p_fr_g,p_fr_w,p_fr_l,p_car_g,p_car_w,p_car_l,year
Lon Kruger,ATL,1,1,82,25,57,82,25,57,82,25,57,.305,,,,,,,,,,2001
Rick Pitino,BOS,4,6,34,12,22,248,102,146,412,192,220,.466,,,,,,,13,6,7,2001
Jim O'Brien,BOS,1,1,48,24,24,48,24,24,48,24,24,.500,,,,,,,,,,2001
Paul Silas,CHH,3,6,82,46,36,199,117,82,445,195,250,.438,10,6,4,14,7,7,14,7,7,2001
Tim Floyd,CHI,3,3,82,15,67,214,45,169,214,45,169,.210,,,,,,,,,,2001
Randy Wittman,CLE,2,2,82,30,52,164,62,102,164,62,102,.378,,,,,,,,,,2001
Don Nelson,DAL,4,23,82,53,29,280,128,152,1760,979,781,.556,10,4,6,10,4,6,122,55,67,2001
Dan Issel,DEN,5,5,82,40,42,362,171,191,362,171,191,.472,,,,12,6,6,12,6,6,2001
George Irvine,DET,2,5,82,32,50,106,46,60,290,100,190,.345,,,,3,0,3,3,0,3,2001
Dave Cowens,GSW,1,5,82,17,65,82,17,65,329,153,176,.465,,,,,,,12,4,8,2001
Rudy Tomjanovich,HOU,10,10,82,45,37,736,432,304,736,432,304,.587,,,,90,51,39,90,51,39,2001
Isiah Thomas,IND,1,1,82,41,41,82,41,41,82,41,41,.500,4,1,3,4,1,3,4,1,3,2001
Alvin Gentry,LAC,1,5,82,31,51,82,31,51,263,119,144,.452,,,,,,,5,2,3,2001
Phil Jackson,LAL,2,11,82,56,26,164,123,41,902,668,234,.741,16,15,1,39,30,9,191,141,50,2001
Pat Riley,MIA,6,19,82,50,32,460,293,167,1515,1049,466,.692,3,0,3,43,18,25,255,155,100,2001
George Karl,MIL,3,14,82,52,30,214,122,92,1043,625,418,.599,18,10,8,26,12,14,120,57,63,2001
Flip Saunders,MIN,6,6,82,47,35,440,227,213,440,227,213,.516,4,1,3,20,5,15,20,5,15,2001
Byron Scott,NJN,1,1,82,26,56,82,26,56,82,26,56,.317,,,,,,,,,,2001
Jeff Van Gundy,NYK,6,6,82,48,34,401,238,163,401,238,163,.594,5,2,3,69,37,32,69,37,32,2001
Doc Rivers,ORL,2,2,82,43,39,164,84,80,164,84,80,.512,4,1,3,4,1,3,4,1,3,2001
Larry Brown,PHI,4,22,82,56,26,296,164,132,1736,1017,719,.586,23,12,11,41,20,21,166,81,85,2001
Scott Skiles,PHO,2,2,82,51,31,144,91,53,144,91,53,.632,4,1,3,13,5,8,13,5,8,2001
Mike Dunleavy,POR,4,10,82,50,32,296,190,106,788,398,390,.505,3,0,3,36,18,18,59,31,28,2001
Rick Adelman,SAC,3,11,82,55,27,214,126,88,823,483,340,.587,8,3,5,18,7,11,87,43,44,2001
Gregg Popovich,SAS,5,5,82,58,24,360,221,139,360,221,139,.614,13,7,6,43,27,16,43,27,16,2001
Paul Westphal,SEA,3,7,15,6,9,147,76,71,426,267,159,.627,,,,5,2,3,49,27,22,2001
Nate McMillan,SEA,1,1,67,38,29,67,38,29,67,38,29,.567,,,,,,,,,,2001
Lenny Wilkens,TOR,1,28,82,47,35,82,47,35,2242,1226,1016,.547,12,6,6,12,6,6,169,78,91,2001
Jerry Sloan,UTA,13,16,82,53,29,1017,690,327,1232,784,448,.636,5,2,3,143,74,69,149,76,73,2001
Sidney Lowe,VAN,1,3,82,23,59,82,23,59,217,56,161,.258,,,,,,,,,,2001
Leonard Hamilton,WAS,1,1,82,19,63,82,19,63,82,19,63,.232,,,,,,,,,,2001
Lon Kruger,ATL,2,2,82,33,49,164,58,106,164,58,106,.354,,,,,,,,,,2002
Jim O'Brien,BOS,2,2,82,49,33,130,73,57,130,73,57,.562,16,9,7,16,9,7,16,9,7,2002
Paul Silas,CHH,4,7,82,44,38,281,161,120,527,239,288,.454,9,4,5,23,11,12,23,11,12,2002
Tim Floyd,CHI,4,4,25,4,21,239,49,190,239,49,190,.205,,,,,,,,,,2002
Bill Berry,CHI,1,1,2,0,2,2,0,2,2,0,2,.000,,,,,,,,,,2002
Bill Cartwright,CHI,1,1,55,17,38,55,17,38,55,17,38,.309,,,,,,,,,,2002
John Lucas,CLE,1,5,82,29,53,82,29,53,389,165,224,.424,,,,,,,14,6,8,2002
Don Nelson,DAL,5,24,82,57,25,362,185,177,1842,1036,806,.562,8,4,4,18,8,10,130,59,71,2002
Dan Issel,DEN,6,6,26,9,17,388,180,208,388,180,208,.464,,,,12,6,6,12,6,6,2002
Mike Evans,DEN,1,1,56,18,38,56,18,38,56,18,38,.321,,,,,,,,,,2002
Rick Carlisle,DET,1,1,82,50,32,82,50,32,82,50,32,.610,10,4,6,10,4,6,10,4,6,2002
Dave Cowens,GSW,2,6,23,8,15,105,25,80,352,161,191,.457,,,,,,,12,4,8,2002
Brian Winters,GSW,1,3,59,13,46,59,13,46,184,36,148,.196,,,,,,,,,,2002
Rudy Tomjanovich,HOU,11,11,82,28,54,818,460,358,818,460,358,.562,,,,90,51,39,90,51,39,2002
Isiah Thomas,IND,2,2,82,42,40,164,83,81,164,83,81,.506,5,2,3,9,3,6,9,3,6,2002
Alvin Gentry,LAC,2,6,82,39,43,164,70,94,345,158,187,.458,,,,,,,5,2,3,2002
Phil Jackson,LAL,3,12,82,58,24,246,181,65,984,726,258,.738,19,15,4,58,45,13,210,156,54,2002
Sidney Lowe,MEM,2,4,82,23,59,164,46,118,299,79,220,.264,,,,,,,,,,2002
Pat Riley,MIA,7,20,82,36,46,542,329,213,1597,1085,512,.679,,,,43,18,25,255,155,100,2002
George Karl,MIL,4,15,82,41,41,296,163,133,1125,666,459,.592,,,,26,12,14,120,57,63,2002
Flip Saunders,MIN,7,7,82,50,32,522,277,245,522,277,245,.531,3,0,3,23,5,18,23,5,18,2002
Byron Scott,NJN,2,2,82,52,30,164,78,86,164,78,86,.476,20,11,9,20,11,9,20,11,9,2002
Jeff Van Gundy,NYK,7,7,19,10,9,420,248,172,420,248,172,.590,,,,69,37,32,69,37,32,2002
Don Chaney,NYK,1,10,63,20,43,63,20,43,710,285,425,.401,,,,,,,11,2,9,2002
Doc Rivers,ORL,3,3,82,44,38,246,128,118,246,128,118,.520,4,1,3,8,2,6,8,2,6,2002
Larry Brown,PHI,5,23,82,43,39,378,207,171,1818,1060,758,.583,5,2,3,46,22,24,171,83,88,2002
Scott Skiles,PHO,3,3,51,25,26,195,116,79,195,116,79,.595,,,,13,5,8,13,5,8,2002
Frank Johnson,PHO,1,1,31,11,20,31,11,20,31,11,20,.355,,,,,,,,,,2002
Maurice Cheeks,POR,1,1,82,49,33,82,49,33,82,49,33,.598,3,0,3,3,0,3,3,0,3,2002
Rick Adelman,SAC,4,12,82,61,21,296,187,109,905,544,361,.601,16,10,6,34,17,17,103,53,50,2002
Gregg Popovich,SAS,6,6,82,58,24,442,279,163,442,279,163,.631,10,4,6,53,31,22,53,31,22,2002
Nate McMillan,SEA,2,2,82,45,37,149,83,66,149,83,66,.557,5,2,3,5,2,3,5,2,3,2002
Lenny Wilkens,TOR,2,29,82,42,40,164,89,75,2324,1268,1056,.546,5,2,3,17,8,9,174,80,94,2002
Jerry Sloan,UTA,14,17,82,44,38,1099,734,365,1314,828,486,.630,4,1,3,147,75,72,153,77,76,2002
Doug Collins,WAS,1,7,82,37,45,82,37,45,537,295,242,.549,,,,,,,38,15,23,2002
Lon Kruger,ATL,3,3,27,11,16,191,69,122,191,69,122,.361,,,,,,,,,,2003
Terry Stotts,ATL,1,1,55,24,31,55,24,31,55,24,31,.436,,,,,,,,,,2003
Jim O'Brien,BOS,3,3,82,44,38,212,117,95,212,117,95,.552,10,4,6,26,13,13,26,13,13,2003
Bill Cartwright,CHI,2,2,82,30,52,137,47,90,137,47,90,.343,,,,,,,,,,2003
John Lucas,CLE,2,6,42,8,34,124,37,87,431,173,258,.401,,,,,,,14,6,8,2003
Keith Smart,CLE,1,1,40,9,31,40,9,31,40,9,31,.225,,,,,,,,,,2003
Don Nelson,DAL,6,25,82,60,22,444,245,199,1924,1096,828,.570,20,10,10,38,18,20,150,69,81,2003
Jeff Bzdelik,DEN,1,1,82,17,65,82,17,65,82,17,65,.207,,,,,,,,,,2003
Rick Carlisle,DET,2,2,82,50,32,164,100,64,164,100,64,.610,17,8,9,27,12,15,27,12,15,2003
Eric Musselman,GSW,1,1,82,38,44,82,38,44,82,38,44,.463,,,,,,,,,,2003
Rudy Tomjanovich,HOU,12,12,82,43,39,900,503,397,900,503,397,.559,,,,90,51,39,90,51,39,2003
Isiah Thomas,IND,3,3,82,48,34,246,131,115,246,131,115,.533,6,2,4,15,5,10,15,5,10,2003
Alvin Gentry,LAC,3,7,58,19,39,222,89,133,403,177,226,.439,,,,,,,5,2,3,2003
Dennis Johnson,LAC,1,1,24,8,16,24,8,16,24,8,16,.333,,,,,,,,,,2003
Phil Jackson,LAL,4,13,82,50,32,328,231,97,1066,776,290,.728,12,6,6,70,51,19,222,162,60,2003
Sidney Lowe,MEM,3,5,8,0,8,172,46,126,307,79,228,.257,,,,,,,,,,2003
Hubie Brown,MEM,1,13,74,28,46,74,28,46,993,473,520,.476,,,,,,,59,31,28,2003
Pat Riley,MIA,8,21,82,25,57,624,354,270,1679,1110,569,.661,,,,43,18,25,255,155,100,2003
George Karl,MIL,5,16,82,42,40,378,205,173,1207,708,499,.587,6,2,4,32,14,18,126,59,67,2003
Flip Saunders,MIN,8,8,82,51,31,604,328,276,604,328,276,.543,6,2,4,29,7,22,29,7,22,2003
Byron Scott,NJN,3,3,82,49,33,246,127,119,246,127,119,.516,20,14,6,40,25,15,40,25,15,2003
Paul Silas,NOH,1,8,82,47,35,82,47,35,609,286,323,.470,6,2,4,6,2,4,29,13,16,2003
Don Chaney,NYK,2,11,82,37,45,145,57,88,792,322,470,.407,,,,,,,11,2,9,2003
Doc Rivers,ORL,4,4,82,42,40,328,170,158,328,170,158,.518,7,3,4,15,5,10,15,5,10,2003
Larry Brown,PHI,6,24,82,48,34,460,255,205,1900,1108,792,.583,12,6,6,58,28,30,183,89,94,2003
Frank Johnson,PHO,2,2,82,44,38,113,55,58,113,55,58,.487,6,2,4,6,2,4,6,2,4,2003
Maurice Cheeks,POR,2,2,82,50,32,164,99,65,164,99,65,.604,7,3,4,10,3,7,10,3,7,2003
Rick Adelman,SAC,5,13,82,59,23,378,246,132,987,603,384,.611,12,7,5,46,24,22,115,60,55,2003
Gregg Popovich,SAS,7,7,82,60,22,524,339,185,524,339,185,.647,24,16,8,77,47,30,77,47,30,2003
Nate McMillan,SEA,3,3,82,40,42,231,123,108,231,123,108,.532,,,,5,2,3,5,2,3,2003
Lenny Wilkens,TOR,3,30,82,24,58,246,113,133,2406,1292,1114,.537,,,,17,8,9,174,80,94,2003
Jerry Sloan,UTA,15,18,82,47,35,1181,781,400,1396,875,521,.627,5,1,4,152,76,76,158,78,80,2003
Doug Collins,WAS,2,8,82,37,45,164,74,90,619,332,287,.536,,,,,,,38,15,23,2003
Terry Stotts,ATL,2,2,82,28,54,137,52,85,137,52,85,.380,,,,,,,,,,2004
Jim O'Brien,BOS,4,4,46,22,24,258,139,119,258,139,119,.539,,,,26,13,13,26,13,13,2004
John Carroll,BOS,1,1,36,14,22,36,14,22,36,14,22,.389,4,0,4,4,0,4,4,0,4,2004
Bill Cartwright,CHI,3,3,14,4,10,151,51,100,151,51,100,.338,,,,,,,,,,2004
Pete Myers,CHI,1,1,2,0,2,2,0,2,2,0,2,.000,,,,,,,,,,2004
Scott Skiles,CHI,1,4,66,19,47,66,19,47,261,135,126,.517,,,,,,,13,5,8,2004
Paul Silas,CLE,1,9,82,35,47,82,35,47,691,321,370,.465,,,,,,,29,13,16,2004
Don Nelson,DAL,7,26,82,52,30,526,297,229,2006,1148,858,.572,5,1,4,43,19,24,155,70,85,2004
Jeff Bzdelik,DEN,2,2,82,43,39,164,60,104,164,60,104,.366,5,1,4,5,1,4,5,1,4,2004
Larry Brown,DET,1,25,82,54,28,82,54,28,1982,1162,820,.586,23,16,7,23,16,7,206,105,101,2004
Eric Musselman,GSW,2,2,82,37,45,164,75,89,164,75,89,.457,,,,,,,,,,2004
Jeff Van Gundy,HOU,1,8,82,45,37,82,45,37,502,293,209,.584,5,1,4,5,1,4,74,38,36,2004
Rick Carlisle,IND,1,3,82,61,21,82,61,21,246,161,85,.654,16,10,6,16,10,6,43,22,21,2004
Mike Dunleavy,LAC,1,11,82,28,54,82,28,54,870,426,444,.490,,,,,,,59,31,28,2004
Phil Jackson,LAL,5,14,82,56,26,410,287,123,1148,832,316,.725,22,13,9,92,64,28,244,175,69,2004
Hubie Brown,MEM,2,14,82,50,32,156,78,78,1075,523,552,.487,4,0,4,4,0,4,63,31,32,2004
Stan Van Gundy,MIA,1,1,82,42,40,82,42,40,82,42,40,.512,13,6,7,13,6,7,13,6,7,2004
Terry Porter,MIL,1,1,82,41,41,82,41,41,82,41,41,.500,5,1,4,5,1,4,5,1,4,2004
Flip Saunders,MIN,9,9,82,58,24,686,386,300,686,386,300,.563,18,10,8,47,17,30,47,17,30,2004
Byron Scott,NJN,4,4,42,22,20,288,149,139,288,149,139,.517,,,,40,25,15,40,25,15,2004
Lawrence Frank,NJN,1,1,40,25,15,40,25,15,40,25,15,.625,11,7,4,11,7,4,11,7,4,2004
Tim Floyd,NOH,1,5,82,41,41,82,41,41,321,90,231,.280,7,3,4,7,3,4,7,3,4,2004
Don Chaney,NYK,3,12,39,15,24,184,72,112,831,337,494,.406,,,,,,,11,2,9,2004
Herb Williams,NYK,1,1,1,1,0,1,1,0,1,1,0,1.000,,,,,,,,,,2004
Lenny Wilkens,NYK,1,31,42,23,19,42,23,19,2448,1315,1133,.537,4,0,4,4,0,4,178,80,98,2004
Doc Rivers,ORL,5,5,11,1,10,339,171,168,339,171,168,.504,,,,15,5,10,15,5,10,2004
Johnny Davis,ORL,1,2,71,20,51,71,20,51,153,42,111,.275,,,,,,,,,,2004
Randy Ayers,PHI,1,1,52,21,31,52,21,31,52,21,31,.404,,,,,,,,,,2004
Chris Ford,PHI,1,10,30,12,18,30,12,18,699,323,376,.462,,,,,,,29,13,16,2004
Frank Johnson,PHO,3,3,21,8,13,134,63,71,134,63,71,.470,,,,6,2,4,6,2,4,2004
Mike D'Antoni,PHO,1,2,61,21,40,61,21,40,111,35,76,.315,,,,,,,,,,2004
Maurice Cheeks,POR,3,3,82,41,41,246,140,106,246,140,106,.569,,,,10,3,7,10,3,7,2004
Rick Adelman,SAC,6,14,82,55,27,460,301,159,1069,658,411,.616,12,7,5,58,31,27,127,67,60,2004
Gregg Popovich,SAS,8,8,82,57,25,606,396,210,606,396,210,.653,10,6,4,87,53,34,87,53,34,2004
Nate McMillan,SEA,4,4,82,37,45,313,160,153,313,160,153,.511,,,,5,2,3,5,2,3,2004
Kevin O'Neill,TOR,1,1,82,33,49,82,33,49,82,33,49,.402,,,,,,,,,,2004
Jerry Sloan,UTA,16,19,82,42,40,1263,823,440,1478,917,561,.620,,,,152,76,76,158,78,80,2004
Eddie Jordan,WAS,1,3,82,25,57,82,25,57,179,58,121,.324,,,,,,,,,,2004
Mike Woodson,ATL,1,1,82,13,69,82,13,69,82,13,69,.159,,,,,,,,,,2005
Doc Rivers,BOS,1,6,82,45,37,82,45,37,421,216,205,.513,7,3,4,7,3,4,22,8,14,2005
Bernie Bickerstaff,CHA,1,11,82,18,64,82,18,64,768,356,412,.464,,,,,,,33,12,21,2005
Scott Skiles,CHI,2,5,82,47,35,148,66,82,343,182,161,.531,6,2,4,6,2,4,19,7,12,2005
Paul Silas,CLE,2,10,64,34,30,146,69,77,755,355,400,.470,,,,,,,29,13,16,2005
Brendan Malone,CLE,1,2,18,8,10,18,8,10,100,29,71,.290,,,,,,,,,,2005
Don Nelson,DAL,8,27,64,42,22,590,339,251,2070,1190,880,.575,,,,43,19,24,155,70,85,2005
Avery Johnson,DAL,1,1,18,16,2,18,16,2,18,16,2,.889,13,6,7,13,6,7,13,6,7,2005
Jeff Bzdelik,DEN,3,3,28,13,15,192,73,119,192,73,119,.380,,,,5,1,4,5,1,4,2005
Michael Cooper,DEN,1,1,14,4,10,14,4,10,14,4,10,.286,,,,,,,,,,2005
George Karl,DEN,1,17,40,32,8,40,32,8,1247,740,507,.593,5,1,4,5,1,4,131,60,71,2005
Larry Brown,DET,2,26,82,54,28,164,108,56,2064,1216,848,.589,25,15,10,48,31,17,231,120,111,2005
Mike Montgomery,GSW,1,1,82,34,48,82,34,48,82,34,48,.415,,,,,,,,,,2005
Jeff Van Gundy,HOU,2,9,82,51,31,164,96,68,584,344,240,.589,7,3,4,12,4,8,81,41,40,2005
Rick Carlisle,IND,2,4,82,44,38,164,105,59,328,205,123,.625,13,6,7,29,16,13,56,28,28,2005
Mike Dunleavy,LAC,2,12,82,37,45,164,65,99,952,463,489,.486,,,,,,,59,31,28,2005
Rudy Tomjanovich,LAL,1,13,43,24,19,43,24,19,943,527,416,.559,,,,,,,90,51,39,2005
Frank Hamblen,LAL,1,2,39,10,29,39,10,29,104,33,71,.317,,,,,,,,,,2005
Hubie Brown,MEM,3,15,12,5,7,168,83,85,1087,528,559,.486,,,,4,0,4,63,31,32,2005
Lionel Hollins,MEM,2,2,4,0,4,64,18,46,64,18,46,.281,,,,,,,,,,2005
Mike Fratello,MEM,1,15,66,40,26,66,40,26,1103,612,491,.555,4,0,4,4,0,4,58,20,38,2005
Stan Van Gundy,MIA,2,2,82,59,23,164,101,63,164,101,63,.616,15,11,4,28,17,11,28,17,11,2005
Terry Porter,MIL,2,2,82,30,52,164,71,93,164,71,93,.433,,,,5,1,4,5,1,4,2005
Flip Saunders,MIN,10,10,51,25,26,737,411,326,737,411,326,.558,,,,47,17,30,47,17,30,2005
Kevin McHale,MIN,1,1,31,19,12,31,19,12,31,19,12,.613,,,,,,,,,,2005
Lawrence Frank,NJN,2,2,82,42,40,122,67,55,122,67,55,.549,4,0,4,15,7,8,15,7,8,2005
Byron Scott,NOH,1,5,82,18,64,82,18,64,370,167,203,.451,,,,,,,40,25,15,2005
Lenny Wilkens,NYK,2,32,39,17,22,81,40,41,2487,1332,1155,.536,,,,4,0,4,178,80,98,2005
Herb Williams,NYK,2,2,43,16,27,44,17,27,44,17,27,.386,,,,,,,,,,2005
Johnny Davis,ORL,2,3,64,31,33,135,51,84,217,73,144,.336,,,,,,,,,,2005
Chris Jent,ORL,1,1,18,5,13,18,5,13,18,5,13,.278,,,,,,,,,,2005
Jim O'Brien,PHI,1,5,82,43,39,82,43,39,340,182,158,.535,5,1,4,5,1,4,31,14,17,2005
Mike D'Antoni,PHO,2,3,82,62,20,143,83,60,193,97,96,.503,15,9,6,15,9,6,15,9,6,2005
Maurice Cheeks,POR,4,4,55,22,33,301,162,139,301,162,139,.538,,,,10,3,7,10,3,7,2005
Kevin Pritchard,POR,1,1,27,5,22,27,5,22,27,5,22,.185,,,,,,,,,,2005
Rick Adelman,SAC,7,15,82,50,32,542,351,191,1151,708,443,.615,5,1,4,63,32,31,132,68,64,2005
Gregg Popovich,SAS,9,9,82,59,23,688,455,233,688,455,233,.661,23,16,7,110,69,41,110,69,41,2005
Nate McMillan,SEA,5,5,82,52,30,395,212,183,395,212,183,.537,11,6,5,16,8,8,16,8,8,2005
Sam Mitchell,TOR,1,1,82,33,49,82,33,49,82,33,49,.402,,,,,,,,,,2005
Jerry Sloan,UTA,17,20,82,26,56,1345,849,496,1560,943,617,.604,,,,152,76,76,158,78,80,2005
Eddie Jordan,WAS,2,4,82,45,37,164,70,94,261,103,158,.395,10,4,6,10,4,6,10,4,6,2005
Mike Woodson,ATL,2,2,82,26,56,164,39,125,164,39,125,.238,,,,,,,,,,2006
Doc Rivers,BOS,2,7,82,33,49,164,78,86,503,249,254,.495,,,,7,3,4,22,8,14,2006
Bernie Bickerstaff,CHA,2,12,82,26,56,164,44,120,850,382,468,.449,,,,,,,33,12,21,2006
Scott Skiles,CHI,3,6,82,41,41,230,107,123,425,223,202,.525,6,2,4,12,4,8,25,9,16,2006
Mike Brown,CLE,1,1,82,50,32,82,50,32,82,50,32,.610,13,7,6,13,7,6,13,7,6,2006
Avery Johnson,DAL,2,2,82,60,22,100,76,24,100,76,24,.760,23,14,9,36,20,16,36,20,16,2006
George Karl,DEN,2,18,82,44,38,122,76,46,1329,784,545,.590,5,1,4,10,2,8,136,61,75,2006
Flip Saunders,DET,1,11,82,64,18,82,64,18,819,475,344,.580,18,10,8,18,10,8,65,27,38,2006
Mike Montgomery,GSW,2,2,82,34,48,164,68,96,164,68,96,.415,,,,,,,,,,2006
Jeff Van Gundy,HOU,3,10,82,34,48,246,130,116,666,378,288,.568,,,,12,4,8,81,41,40,2006
Rick Carlisle,IND,3,5,82,41,41,246,146,100,410,246,164,.600,6,2,4,35,18,17,62,30,32,2006
Mike Dunleavy,LAC,3,13,82,47,35,246,112,134,1034,510,524,.493,12,7,5,12,7,5,71,38,33,2006
Phil Jackson,LAL,6,15,82,45,37,492,332,160,1230,877,353,.713,7,3,4,99,67,32,251,178,73,2006
Mike Fratello,MEM,2,16,82,49,33,148,89,59,1185,661,524,.558,4,0,4,8,0,8,62,20,42,2006
Stan Van Gundy,MIA,3,3,21,11,10,185,112,73,185,112,73,.605,,,,28,17,11,28,17,11,2006
Pat Riley,MIA,9,22,61,41,20,685,395,290,1740,1151,589,.661,23,16,7,66,34,32,278,171,107,2006
Terry Stotts,MIL,1,3,82,40,42,82,40,42,219,92,127,.420,5,1,4,5,1,4,5,1,4,2006
Dwane Casey,MIN,1,1,82,33,49,82,33,49,82,33,49,.402,,,,,,,,,,2006
Lawrence Frank,NJN,3,3,82,49,33,204,116,88,204,116,88,.569,11,5,6,26,12,14,26,12,14,2006
Byron Scott,NOK,2,6,82,38,44,164,56,108,452,205,247,.454,,,,,,,40,25,15,2006
Larry Brown,NYK,1,27,82,23,59,82,23,59,2146,1239,907,.577,,,,,,,231,120,111,2006
Brian Hill,ORL,5,8,82,36,46,377,227,150,531,258,273,.486,,,,36,18,18,36,18,18,2006
Maurice Cheeks,PHI,1,5,82,38,44,82,38,44,383,200,183,.522,,,,,,,10,3,7,2006
Mike D'Antoni,PHO,3,4,82,54,28,225,137,88,275,151,124,.549,20,10,10,35,19,16,35,19,16,2006
Nate McMillan,POR,1,6,82,21,61,82,21,61,477,233,244,.488,,,,,,,16,8,8,2006
Rick Adelman,SAC,8,16,82,44,38,624,395,229,1233,752,481,.610,6,2,4,69,34,35,138,70,68,2006
Gregg Popovich,SAS,10,10,82,63,19,770,518,252,770,518,252,.673,13,7,6,123,76,47,123,76,47,2006
Bob Weiss,SEA,1,7,30,13,17,30,13,17,522,223,299,.427,,,,,,,11,2,9,2006
Bob Hill,SEA,1,8,52,22,30,52,22,30,521,279,242,.536,,,,,,,37,17,20,2006
Sam Mitchell,TOR,2,2,82,27,55,164,60,104,164,60,104,.366,,,,,,,,,,2006
Jerry Sloan,UTA,18,21,82,41,41,1427,890,537,1642,984,658,.599,,,,152,76,76,158,78,80,2006
Eddie Jordan,WAS,3,5,82,42,40,246,112,134,343,145,198,.423,6,2,4,16,6,10,16,6,10,2006
Mike Woodson,ATL,3,3,82,30,52,246,69,177,246,69,177,.280,,,,,,,,,,2007
Doc Rivers,BOS,3,8,82,24,58,246,102,144,585,273,312,.467,,,,7,3,4,22,8,14,2007
Bernie Bickerstaff,CHA,3,13,82,33,49,246,77,169,932,415,517,.445,,,,,,,33,12,21,2007
Scott Skiles,CHI,4,7,82,49,33,312,156,156,507,272,235,.536,10,6,4,22,10,12,35,15,20,2007
Mike Brown,CLE,2,2,82,50,32,164,100,64,164,100,64,.610,20,12,8,33,19,14,33,19,14,2007
Avery Johnson,DAL,3,3,82,67,15,182,143,39,182,143,39,.786,6,2,4,42,22,20,42,22,20,2007
George Karl,DEN,3,19,82,45,37,204,121,83,1411,829,582,.588,5,1,4,15,3,12,141,62,79,2007
Flip Saunders,DET,2,12,82,53,29,164,117,47,901,528,373,.586,16,10,6,34,20,14,81,37,44,2007
Don Nelson,GSW,8,28,82,42,40,619,319,300,2152,1232,920,.572,11,5,6,35,14,21,166,75,91,2007
Jeff Van Gundy,HOU,4,11,82,52,30,328,182,146,748,430,318,.575,7,3,4,19,7,12,88,44,44,2007
Rick Carlisle,IND,4,6,82,35,47,328,181,147,492,281,211,.571,,,,35,18,17,62,30,32,2007
Mike Dunleavy,LAC,4,14,82,40,42,328,152,176,1116,550,566,.493,,,,12,7,5,71,38,33,2007
Phil Jackson,LAL,7,16,82,42,40,574,374,200,1312,919,393,.700,5,1,4,104,68,36,256,179,77,2007
Mike Fratello,MEM,3,17,30,6,24,178,95,83,1215,667,548,.549,,,,8,0,8,62,20,42,2007
Tony Barone,MEM,1,1,52,16,36,52,16,36,52,16,36,.308,,,,,,,,,,2007
Pat Riley,MIA,10,23,82,44,38,767,439,328,1822,1195,627,.656,4,0,4,70,34,36,282,171,111,2007
Terry Stotts,MIL,2,4,64,23,41,146,63,83,283,115,168,.406,,,,5,1,4,5,1,4,2007
Larry Krystkowiak,MIL,1,1,18,5,13,18,5,13,18,5,13,.278,,,,,,,,,,2007
Dwane Casey,MIN,2,2,40,20,20,122,53,69,122,53,69,.434,,,,,,,,,,2007
Randy Wittman,MIN,1,3,42,12,30,42,12,30,206,74,132,.359,,,,,,,,,,2007
Lawrence Frank,NJN,4,4,82,41,41,286,157,129,286,157,129,.549,12,6,6,38,18,20,38,18,20,2007
Byron Scott,NOK,3,7,82,39,43,246,95,151,534,244,290,.457,,,,,,,40,25,15,2007
Isiah Thomas,NYK,1,4,82,33,49,82,33,49,328,164,164,.500,,,,,,,15,5,10,2007
Brian Hill,ORL,6,9,82,40,42,459,267,192,613,298,315,.486,4,0,4,40,18,22,40,18,22,2007
Maurice Cheeks,PHI,2,6,82,35,47,164,73,91,465,235,230,.505,,,,,,,10,3,7,2007
Mike D'Antoni,PHO,4,5,82,61,21,307,198,109,357,212,145,.594,11,6,5,46,25,21,46,25,21,2007
Nate McMillan,POR,2,7,82,32,50,164,53,111,559,265,294,.474,,,,,,,16,8,8,2007
Eric Musselman,SAC,1,3,82,33,49,82,33,49,246,108,138,.439,,,,,,,,,,2007
Gregg Popovich,SAS,11,11,82,58,24,852,576,276,852,576,276,.676,20,16,4,143,92,51,143,92,51,2007
Bob Hill,SEA,2,9,82,31,51,134,53,81,603,310,293,.514,,,,,,,37,17,20,2007
Sam Mitchell,TOR,3,3,82,47,35,246,107,139,246,107,139,.435,6,2,4,6,2,4,6,2,4,2007
Jerry Sloan,UTA,19,22,82,51,31,1509,941,568,1724,1035,689,.600,17,9,8,169,85,84,175,87,88,2007
Eddie Jordan,WAS,4,6,82,41,41,328,153,175,425,186,239,.438,4,0,4,20,6,14,20,6,14,2007
Mike Woodson,ATL,4,4,82,37,45,328,106,222,328,106,222,.323,7,3,4,7,3,4,7,3,4,2008
Doc Rivers,BOS,4,9,82,66,16,328,168,160,667,339,328,.508,26,16,10,33,19,14,48,24,24,2008
Sam Vincent,CHA,1,1,82,32,50,82,32,50,82,32,50,.390,,,,,,,,,,2008
Scott Skiles,CHI,5,8,25,9,16,337,165,172,532,281,251,.528,,,,22,10,12,35,15,20,2008
Pete Myers,CHI,2,2,1,0,1,3,0,3,3,0,3,.000,,,,,,,,,,2008
Jim Boylan,CHI,1,1,56,24,32,56,24,32,56,24,32,.429,,,,,,,,,,2008
Mike Brown,CLE,3,3,82,45,37,246,145,101,246,145,101,.589,13,7,6,46,26,20,46,26,20,2008
Avery Johnson,DAL,4,4,82,51,31,264,194,70,264,194,70,.735,5,1,4,47,23,24,47,23,24,2008
George Karl,DEN,4,20,82,50,32,286,171,115,1493,879,614,.589,4,0,4,19,3,16,145,62,83,2008
Flip Saunders,DET,3,13,82,59,23,246,176,70,983,587,396,.597,17,10,7,51,30,21,98,47,51,2008
Don Nelson,GSW,9,29,82,48,34,701,367,334,2234,1280,954,.573,,,,35,14,21,166,75,91,2008
Rick Adelman,HOU,1,17,82,55,27,82,55,27,1315,807,508,.614,6,2,4,6,2,4,144,72,72,2008
Jim O'Brien,IND,1,6,82,36,46,82,36,46,422,218,204,.517,,,,,,,31,14,17,2008
Mike Dunleavy,LAC,5,15,82,23,59,410,175,235,1198,573,625,.478,,,,12,7,5,71,38,33,2008
Phil Jackson,LAL,8,17,82,57,25,656,431,225,1394,976,418,.700,21,14,7,125,82,43,277,193,84,2008
Marc Iavaroni,MEM,1,1,82,22,60,82,22,60,82,22,60,.268,,,,,,,,,,2008
Pat Riley,MIA,11,24,82,15,67,849,454,395,1904,1210,694,.636,,,,70,34,36,282,171,111,2008
Larry Krystkowiak,MIL,2,2,82,26,56,100,31,69,100,31,69,.310,,,,,,,,,,2008
Randy Wittman,MIN,2,4,82,22,60,124,34,90,288,96,192,.333,,,,,,,,,,2008
Lawrence Frank,NJN,5,5,82,34,48,368,191,177,368,191,177,.519,,,,38,18,20,38,18,20,2008
Byron Scott,NOH,4,8,82,56,26,328,151,177,616,300,316,.487,12,7,5,12,7,5,52,32,20,2008
Isiah Thomas,NYK,2,5,82,23,59,164,56,108,410,187,223,.456,,,,,,,15,5,10,2008
Stan Van Gundy,ORL,1,4,82,52,30,82,52,30,267,164,103,.614,10,5,5,10,5,5,38,22,16,2008
Maurice Cheeks,PHI,3,7,82,40,42,246,113,133,547,275,272,.503,6,2,4,6,2,4,16,5,11,2008
Mike D'Antoni,PHO,5,6,82,55,27,389,253,136,439,267,172,.608,5,1,4,51,26,25,51,26,25,2008
Nate McMillan,POR,3,8,82,41,41,246,94,152,641,306,335,.477,,,,,,,16,8,8,2008
Reggie Theus,SAC,1,1,82,38,44,82,38,44,82,38,44,.463,,,,,,,,,,2008
Gregg Popovich,SAS,12,12,82,56,26,934,632,302,934,632,302,.677,17,9,8,160,101,59,160,101,59,2008
P.J. Carlesimo,SEA,1,7,82,20,62,82,20,62,487,203,284,.417,,,,,,,12,3,9,2008
Sam Mitchell,TOR,4,4,82,41,41,328,148,180,328,148,180,.451,5,1,4,11,3,8,11,3,8,2008
Jerry Sloan,UTA,20,23,82,54,28,1591,995,596,1806,1089,717,.603,12,6,6,181,91,90,187,93,94,2008
Eddie Jordan,WAS,5,7,82,43,39,410,196,214,507,229,278,.452,6,2,4,26,8,18,26,8,18,2008
Mike Woodson,ATL,5,5,82,47,35,410,153,257,410,153,257,.373,11,4,7,18,7,11,18,7,11,2009
Doc Rivers,BOS,5,10,82,62,20,410,230,180,749,401,348,.535,14,7,7,47,26,21,62,31,31,2009
Larry Brown,CHA,1,28,82,35,47,82,35,47,2228,1274,954,.572,,,,,,,231,120,111,2009
Vinny Del Negro,CHI,1,1,82,41,41,82,41,41,82,41,41,.500,7,3,4,7,3,4,7,3,4,2009
Mike Brown,CLE,4,4,82,66,16,328,211,117,328,211,117,.643,14,10,4,60,36,24,60,36,24,2009
Rick Carlisle,DAL,1,7,82,50,32,82,50,32,574,331,243,.577,10,5,5,10,5,5,72,35,37,2009
George Karl,DEN,5,21,82,54,28,368,225,143,1575,933,642,.592,16,10,6,35,13,22,161,72,89,2009
Michael Curry,DET,1,1,82,39,43,82,39,43,82,39,43,.476,4,0,4,4,0,4,4,0,4,2009
Don Nelson,GSW,10,30,82,29,53,783,396,387,2316,1309,1007,.565,,,,35,14,21,166,75,91,2009
Rick Adelman,HOU,2,18,82,53,29,164,108,56,1397,860,537,.616,13,7,6,19,9,10,157,79,78,2009
Jim O'Brien,IND,2,7,82,36,46,164,72,92,504,254,250,.504,,,,,,,31,14,17,2009
Mike Dunleavy,LAC,6,16,82,19,63,492,194,298,1280,592,688,.463,,,,12,7,5,71,38,33,2009
Phil Jackson,LAL,9,18,82,65,17,738,496,242,1476,1041,435,.705,23,16,7,148,98,50,300,209,91,2009
Marc Iavaroni,MEM,2,2,41,11,30,123,33,90,123,33,90,.268,,,,,,,,,,2009
Johnny Davis,MEM,1,4,2,0,2,2,0,2,219,73,146,.333,,,,,,,,,,2009
Lionel Hollins,MEM,3,3,39,13,26,103,31,72,103,31,72,.301,,,,,,,,,,2009
Erik Spoelstra,MIA,1,1,82,43,39,82,43,39,82,43,39,.524,7,3,4,7,3,4,7,3,4,2009
Scott Skiles,MIL,1,9,82,34,48,82,34,48,614,315,299,.513,,,,,,,35,15,20,2009
Randy Wittman,MIN,3,5,19,4,15,143,38,105,307,100,207,.326,,,,,,,,,,2009
Kevin McHale,MIN,2,2,63,20,43,94,39,55,94,39,55,.415,,,,,,,,,,2009
Lawrence Frank,NJN,6,6,82,34,48,450,225,225,450,225,225,.500,,,,38,18,20,38,18,20,2009
Byron Scott,NOH,5,9,82,49,33,410,200,210,698,349,349,.500,5,1,4,17,8,9,57,33,24,2009
Mike D'Antoni,NYK,1,7,82,32,50,82,32,50,521,299,222,.574,,,,,,,51,26,25,2009
P.J. Carlesimo,OKC,2,8,13,1,12,95,21,74,500,204,296,.408,,,,,,,12,3,9,2009
Scott Brooks,OKC,1,1,69,22,47,69,22,47,69,22,47,.319,,,,,,,,,,2009
Stan Van Gundy,ORL,2,5,82,59,23,164,111,53,349,223,126,.639,24,13,11,34,18,16,62,35,27,2009
Maurice Cheeks,PHI,4,8,23,9,14,269,122,147,570,284,286,.498,,,,6,2,4,16,5,11,2009
Tony DiLeo,PHI,1,1,59,32,27,59,32,27,59,32,27,.542,6,2,4,6,2,4,6,2,4,2009
Terry Porter,PHO,1,3,51,28,23,51,28,23,215,99,116,.460,,,,,,,5,1,4,2009
Alvin Gentry,PHO,1,8,31,18,13,31,18,13,434,195,239,.449,,,,,,,5,2,3,2009
Nate McMillan,POR,4,9,82,54,28,328,148,180,723,360,363,.498,6,2,4,6,2,4,22,10,12,2009
Reggie Theus,SAC,2,2,24,6,18,106,44,62,106,44,62,.415,,,,,,,,,,2009
Kenny Natt,SAC,1,1,58,11,47,58,11,47,58,11,47,.190,,,,,,,,,,2009
Gregg Popovich,SAS,13,13,82,54,28,1016,686,330,1016,686,330,.675,5,1,4,165,102,63,165,102,63,2009
Sam Mitchell,TOR,5,5,17,8,9,345,156,189,345,156,189,.452,,,,11,3,8,11,3,8,2009
Jay Triano,TOR,1,1,65,25,40,65,25,40,65,25,40,.385,,,,,,,,,,2009
Jerry Sloan,UTA,21,24,82,48,34,1673,1043,630,1888,1137,751,.602,5,1,4,186,92,94,192,94,98,2009
Eddie Jordan,WAS,6,8,11,1,10,421,197,224,518,230,288,.444,,,,26,8,18,26,8,18,2009
Ed Tapscott,WAS,1,1,71,18,53,71,18,53,71,18,53,.254,,,,,,,,,,2009
Mike Woodson,ATL,6,6,82,53,29,492,206,286,492,206,286,.419,11,4,7,29,11,18,29,11,18,2010
Doc Rivers,BOS,6,11,82,50,32,492,280,212,831,451,380,.543,24,15,9,71,41,30,86,46,40,2010
Larry Brown,CHA,2,29,82,44,38,164,79,85,2310,1318,992,.571,4,0,4,4,0,4,235,120,115,2010
Vinny Del Negro,CHI,2,2,82,41,41,164,82,82,164,82,82,.500,5,1,4,12,4,8,12,4,8,2010
Mike Brown,CLE,5,5,82,61,21,410,272,138,410,272,138,.663,11,6,5,71,42,29,71,42,29,2010
Rick Carlisle,DAL,2,8,82,55,27,164,105,59,656,386,270,.588,6,2,4,16,7,9,78,37,41,2010
George Karl,DEN,6,22,82,53,29,450,278,172,1657,986,671,.595,6,2,4,41,15,26,167,74,93,2010
John Kuester,DET,1,1,82,27,55,82,27,55,82,27,55,.329,,,,,,,,,,2010
Don Nelson,GSW,11,31,82,26,56,865,422,443,2398,1335,1063,.557,,,,35,14,21,166,75,91,2010
Rick Adelman,HOU,3,19,82,42,40,246,150,96,1479,902,577,.610,,,,19,9,10,157,79,78,2010
Jim O'Brien,IND,3,8,82,32,50,246,104,142,586,286,300,.488,,,,,,,31,14,17,2010
Mike Dunleavy,LAC,7,17,49,21,28,541,215,326,1329,613,716,.461,,,,12,7,5,71,38,33,2010
Kim Hughes,LAC,1,1,33,8,25,33,8,25,33,8,25,.242,,,,,,,,,,2010
Phil Jackson,LAL,10,19,82,57,25,820,553,267,1558,1098,460,.705,23,16,7,171,114,57,323,225,98,2010
Lionel Hollins,MEM,4,4,82,40,42,185,71,114,185,71,114,.384,,,,,,,,,,2010
Erik Spoelstra,MIA,2,2,82,47,35,164,90,74,164,90,74,.549,5,1,4,12,4,8,12,4,8,2010
Scott Skiles,MIL,2,10,82,46,36,164,80,84,696,361,335,.519,7,3,4,7,3,4,42,18,24,2010
Kurt Rambis,MIN,1,2,82,15,67,82,15,67,119,39,80,.328,,,,,,,8,3,5,2010
Lawrence Frank,NJN,7,7,16,0,16,466,225,241,466,225,241,.483,,,,38,18,20,38,18,20,2010
Tom Barrise,NJN,1,1,2,0,2,2,0,2,2,0,2,.000,,,,,,,,,,2010
Kiki Vandeweghe,NJN,1,1,64,12,52,64,12,52,64,12,52,.188,,,,,,,,,,2010
Byron Scott,NOH,6,10,9,3,6,419,203,216,707,352,355,.498,,,,17,8,9,57,33,24,2010
Jeff Bower,NOH,1,1,73,34,39,73,34,39,73,34,39,.466,,,,,,,,,,2010
Mike D'Antoni,NYK,2,8,82,29,53,164,61,103,603,328,275,.544,,,,,,,51,26,25,2010
Scott Brooks,OKC,2,2,82,50,32,151,72,79,151,72,79,.477,6,2,4,6,2,4,6,2,4,2010
Stan Van Gundy,ORL,3,6,82,59,23,246,170,76,431,282,149,.654,14,10,4,48,28,20,76,45,31,2010
Eddie Jordan,PHI,1,9,82,27,55,82,27,55,600,257,343,.428,,,,,,,26,8,18,2010
Alvin Gentry,PHO,2,9,82,54,28,113,72,41,516,249,267,.483,16,10,6,16,10,6,21,12,9,2010
Nate McMillan,POR,5,10,82,50,32,410,198,212,805,410,395,.509,6,2,4,12,4,8,28,12,16,2010
Paul Westphal,SAC,1,8,82,25,57,82,25,57,508,292,216,.575,,,,,,,49,27,22,2010
Gregg Popovich,SAS,14,14,82,50,32,1098,736,362,1098,736,362,.670,10,4,6,175,106,69,175,106,69,2010
Jay Triano,TOR,2,2,82,40,42,147,65,82,147,65,82,.442,,,,,,,,,,2010
Jerry Sloan,UTA,22,25,82,53,29,1755,1096,659,1970,1190,780,.604,10,4,6,196,96,100,202,98,104,2010
Flip Saunders,WAS,1,14,82,26,56,82,26,56,1065,613,452,.576,,,,,,,98,47,51,2010
Larry Drew,ATL,1,1,82,44,38,82,44,38,82,44,38,.537,12,6,6,12,6,6,12,6,6,2011
Doc Rivers,BOS,7,12,82,56,26,574,336,238,913,507,406,.555,9,5,4,80,46,34,95,51,44,2011
Larry Brown,CHA,3,30,28,9,19,192,88,104,2338,1327,1011,.568,,,,4,0,4,235,120,115,2011
Paul Silas,CHA,5,11,54,25,29,335,186,149,809,380,429,.470,,,,23,11,12,29,13,16,2011
Tom Thibodeau,CHI,1,1,82,62,20,82,62,20,82,62,20,.756,16,9,7,16,9,7,16,9,7,2011
Byron Scott,CLE,1,11,82,19,63,82,19,63,789,371,418,.470,,,,,,,57,33,24,2011
Rick Carlisle,DAL,3,9,82,57,25,246,162,84,738,443,295,.600,21,16,5,37,23,14,99,53,46,2011
George Karl,DEN,7,23,82,50,32,532,328,204,1739,1036,703,.596,5,1,4,46,16,30,172,75,97,2011
John Kuester,DET,2,2,82,30,52,164,57,107,164,57,107,.348,,,,,,,,,,2011
Keith Smart,GSW,1,2,82,36,46,82,36,46,122,45,77,.369,,,,,,,,,,2011
Rick Adelman,HOU,4,20,82,43,39,328,193,135,1561,945,616,.605,,,,19,9,10,157,79,78,2011
Jim O'Brien,IND,4,9,44,17,27,290,121,169,630,303,327,.481,,,,,,,31,14,17,2011
Frank Vogel,IND,1,1,38,20,18,38,20,18,38,20,18,.526,5,1,4,5,1,4,5,1,4,2011
Vinny Del Negro,LAC,1,3,82,32,50,82,32,50,246,114,132,.463,,,,,,,12,4,8,2011
Phil Jackson,LAL,11,20,82,57,25,902,610,292,1640,1155,485,.704,10,4,6,181,118,63,333,229,104,2011
Lionel Hollins,MEM,5,5,82,46,36,267,117,150,267,117,150,.438,13,7,6,13,7,6,13,7,6,2011
Erik Spoelstra,MIA,3,3,82,58,24,246,148,98,246,148,98,.602,21,14,7,33,18,15,33,18,15,2011
Scott Skiles,MIL,3,11,82,35,47,246,115,131,778,396,382,.509,,,,7,3,4,42,18,24,2011
Kurt Rambis,MIN,2,3,82,17,65,164,32,132,201,56,145,.279,,,,,,,8,3,5,2011
Avery Johnson,NJN,1,5,82,24,58,82,24,58,346,218,128,.630,,,,,,,47,23,24,2011
Monty Williams,NOH,1,1,82,46,36,82,46,36,82,46,36,.561,6,2,4,6,2,4,6,2,4,2011
Mike D'Antoni,NYK,3,9,82,42,40,246,103,143,685,370,315,.540,4,0,4,4,0,4,55,26,29,2011
Scott Brooks,OKC,3,3,82,55,27,233,127,106,233,127,106,.545,17,9,8,23,11,12,23,11,12,2011
Stan Van Gundy,ORL,4,7,82,52,30,328,222,106,513,334,179,.651,6,2,4,54,30,24,82,47,35,2011
Doug Collins,PHI,1,9,82,41,41,82,41,41,701,373,328,.532,5,1,4,5,1,4,43,16,27,2011
Alvin Gentry,PHO,3,10,82,40,42,195,112,83,598,289,309,.483,,,,16,10,6,21,12,9,2011
Nate McMillan,POR,6,11,82,48,34,492,246,246,887,458,429,.516,6,2,4,18,6,12,34,14,20,2011
Paul Westphal,SAC,2,9,82,24,58,164,49,115,590,316,274,.536,,,,,,,49,27,22,2011
Gregg Popovich,SAS,15,15,82,61,21,1180,797,383,1180,797,383,.675,6,2,4,181,108,73,181,108,73,2011
Jay Triano,TOR,3,3,82,22,60,229,87,142,229,87,142,.380,,,,,,,,,,2011
Jerry Sloan,UTA,23,26,54,31,23,1809,1127,682,2024,1221,803,.603,,,,196,96,100,202,98,104,2011
Tyrone Corbin,UTA,1,1,28,8,20,28,8,20,28,8,20,.286,,,,,,,,,,2011
Flip Saunders,WAS,2,15,82,23,59,164,49,115,1147,636,511,.554,,,,,,,98,47,51,2011
Larry Drew,ATL,2,2,66,40,26,148,84,64,148,84,64,.568,6,2,4,18,8,10,18,8,10,2012
Doc Rivers,BOS,8,13,66,39,27,640,375,265,979,546,433,.558,20,11,9,100,57,43,115,62,53,2012
Paul Silas,CHA,6,12,66,7,59,401,193,208,875,387,488,.442,,,,23,11,12,29,13,16,2012
Tom Thibodeau,CHI,2,2,66,50,16,148,112,36,148,112,36,.757,6,2,4,22,11,11,22,11,11,2012
Byron Scott,CLE,2,12,66,21,45,148,40,108,855,392,463,.458,,,,,,,57,33,24,2012
Rick Carlisle,DAL,4,10,66,36,30,312,198,114,804,479,325,.596,4,0,4,41,23,18,103,53,50,2012
George Karl,DEN,8,24,66,38,28,598,366,232,1805,1074,731,.595,7,3,4,53,19,34,179,78,101,2012
Lawrence Frank,DET,1,8,66,25,41,66,25,41,532,250,282,.470,,,,,,,38,18,20,2012
Mark Jackson,GSW,1,1,66,23,43,66,23,43,66,23,43,.348,,,,,,,,,,2012
Kevin McHale,HOU,1,3,66,34,32,66,34,32,160,73,87,.456,,,,,,,,,,2012
Frank Vogel,IND,2,2,66,42,24,104,62,42,104,62,42,.596,11,6,5,16,7,9,16,7,9,2012
Vinny Del Negro,LAC,2,4,66,40,26,148,72,76,312,154,158,.494,11,4,7,11,4,7,23,8,15,2012
Mike Brown,LAL,1,6,66,41,25,66,41,25,476,313,163,.658,12,5,7,12,5,7,83,47,36,2012
Lionel Hollins,MEM,6,6,66,41,25,333,158,175,333,158,175,.474,7,3,4,20,10,10,20,10,10,2012
Erik Spoelstra,MIA,4,4,66,46,20,312,194,118,312,194,118,.622,23,16,7,56,34,22,56,34,22,2012
Scott Skiles,MIL,4,12,66,31,35,312,146,166,844,427,417,.506,,,,7,3,4,42,18,24,2012
Rick Adelman,MIN,1,21,66,26,40,66,26,40,1627,971,656,.597,,,,,,,157,79,78,2012
Avery Johnson,NJN,2,6,66,22,44,148,46,102,412,240,172,.583,,,,,,,47,23,24,2012
Monty Williams,NOH,2,2,66,21,45,148,67,81,148,67,81,.453,,,,6,2,4,6,2,4,2012
Mike D'Antoni,NYK,4,10,42,18,24,288,121,167,727,388,339,.534,,,,4,0,4,55,26,29,2012
Mike Woodson,NYK,1,7,24,18,6,24,18,6,516,224,292,.434,5,1,4,5,1,4,34,12,22,2012
Scott Brooks,OKC,4,4,66,47,19,299,174,125,299,174,125,.582,20,13,7,43,24,19,43,24,19,2012
Stan Van Gundy,ORL,5,8,66,37,29,394,259,135,579,371,208,.641,5,1,4,59,31,28,87,48,39,2012
Doug Collins,PHI,2,10,66,35,31,148,76,72,767,408,359,.532,13,7,6,18,8,10,56,23,33,2012
Alvin Gentry,PHO,4,11,66,33,33,261,145,116,664,322,342,.485,,,,16,10,6,21,12,9,2012
Nate McMillan,POR,7,12,43,20,23,535,266,269,930,478,452,.514,,,,18,6,12,34,14,20,2012
Kaleb Canales,POR,1,1,23,8,15,23,8,15,23,8,15,.348,,,,,,,,,,2012
Paul Westphal,SAC,3,10,7,2,5,171,51,120,597,318,279,.533,,,,,,,49,27,22,2012
Keith Smart,SAC,1,3,59,20,39,59,20,39,181,65,116,.359,,,,,,,,,,2012
Gregg Popovich,SAS,16,16,66,50,16,1246,847,399,1246,847,399,.680,14,10,4,195,118,77,195,118,77,2012
Dwane Casey,TOR,1,3,66,23,43,66,23,43,188,76,112,.404,,,,,,,,,,2012
Tyrone Corbin,UTA,2,2,66,36,30,94,44,50,94,44,50,.468,4,0,4,4,0,4,4,0,4,2012
Flip Saunders,WAS,3,16,17,2,15,181,51,130,1164,638,526,.548,,,,,,,98,47,51,2012
Randy Wittman,WAS,1,6,49,18,31,49,18,31,356,118,238,.331,,,,,,,,,,2012
Larry Drew,ATL,3,3,82,44,38,230,128,102,230,128,102,.557,6,2,4,24,10,14,24,10,14,2013
Doc Rivers,BOS,9,14,81,41,40,721,416,305,1060,587,473,.554,6,2,4,106,59,47,121,64,57,2013
Avery Johnson,BRK,3,7,28,14,14,176,60,116,440,254,186,.577,,,,,,,47,23,24,2013
P.J. Carlesimo,BRK,1,9,54,35,19,54,35,19,554,239,315,.431,7,3,4,7,3,4,19,6,13,2013
Mike Dunlap,CHA,1,1,82,21,61,82,21,61,82,21,61,.256,,,,,,,,,,2013
Tom Thibodeau,CHI,3,3,82,45,37,230,157,73,230,157,73,.683,12,5,7,34,16,18,34,16,18,2013
Byron Scott,CLE,3,13,82,24,58,230,64,166,937,416,521,.444,,,,,,,57,33,24,2013
Rick Carlisle,DAL,5,11,82,41,41,394,239,155,886,520,366,.587,,,,41,23,18,103,53,50,2013
George Karl,DEN,9,25,82,57,25,680,423,257,1887,1131,756,.599,6,2,4,59,21,38,185,80,105,2013
Lawrence Frank,DET,2,9,82,29,53,148,54,94,614,279,335,.454,,,,,,,38,18,20,2013
Mark Jackson,GSW,2,2,82,47,35,148,70,78,148,70,78,.473,12,6,6,12,6,6,12,6,6,2013
Kevin McHale,HOU,2,4,82,45,37,148,79,69,242,118,124,.488,6,2,4,6,2,4,6,2,4,2013
Frank Vogel,IND,3,3,81,49,32,185,111,74,185,111,74,.600,19,11,8,35,18,17,35,18,17,2013
Vinny Del Negro,LAC,3,5,82,56,26,230,128,102,394,210,184,.533,6,2,4,17,6,11,29,10,19,2013
Mike Brown,LAL,2,7,5,1,4,71,42,29,481,314,167,.653,,,,12,5,7,83,47,36,2013
Bernie Bickerstaff,LAL,1,14,5,4,1,5,4,1,937,419,518,.447,,,,,,,33,12,21,2013
Mike D'Antoni,LAL,1,11,72,40,32,72,40,32,799,428,371,.536,4,0,4,4,0,4,59,26,33,2013
Lionel Hollins,MEM,7,7,82,56,26,415,214,201,415,214,201,.516,15,8,7,35,18,17,35,18,17,2013
Erik Spoelstra,MIA,5,5,82,66,16,394,260,134,394,260,134,.660,23,16,7,79,50,29,79,50,29,2013
Scott Skiles,MIL,5,13,32,16,16,344,162,182,876,443,433,.506,,,,7,3,4,42,18,24,2013
Jim Boylan,MIL,1,2,50,22,28,50,22,28,106,46,60,.434,4,0,4,4,0,4,4,0,4,2013
Rick Adelman,MIN,2,22,82,31,51,148,57,91,1709,1002,707,.586,,,,,,,157,79,78,2013
Monty Williams,NOH,3,3,82,27,55,230,94,136,230,94,136,.409,,,,6,2,4,6,2,4,2013
Mike Woodson,NYK,2,8,82,54,28,106,72,34,598,278,320,.465,12,6,6,17,7,10,46,18,28,2013
Scott Brooks,OKC,5,5,82,60,22,381,234,147,381,234,147,.614,11,5,6,54,29,25,54,29,25,2013
Jacque Vaughn,ORL,1,1,82,20,62,82,20,62,82,20,62,.244,,,,,,,,,,2013
Doug Collins,PHI,3,11,82,34,48,230,110,120,849,442,407,.521,,,,18,8,10,56,23,33,2013
Alvin Gentry,PHO,5,12,41,13,28,302,158,144,705,335,370,.475,,,,16,10,6,21,12,9,2013
Lindsey Hunter,PHO,1,1,41,12,29,41,12,29,41,12,29,.293,,,,,,,,,,2013
Terry Stotts,POR,1,5,82,33,49,82,33,49,365,148,217,.405,,,,,,,5,1,4,2013
Keith Smart,SAC,2,4,82,28,54,141,48,93,263,93,170,.354,,,,,,,,,,2013
Gregg Popovich,SAS,17,17,82,58,24,1328,905,423,1328,905,423,.681,21,15,6,216,133,83,216,133,83,2013
Dwane Casey,TOR,2,4,82,34,48,148,57,91,270,110,160,.407,,,,,,,,,,2013
Tyrone Corbin,UTA,3,3,82,43,39,176,87,89,176,87,89,.494,,,,4,0,4,4,0,4,2013
Randy Wittman,WAS,2,7,82,29,53,131,47,84,438,147,291,.336,,,,,,,,,,2013
Mike Budenholzer,ATL,1,1,82,38,44,82,38,44,82,38,44,.463,7,3,4,7,3,4,7,3,4,2014
Brad Stevens,BOS,1,1,82,25,57,82,25,57,82,25,57,.305,,,,,,,,,,2014
Jason Kidd,BRK,1,1,82,44,38,82,44,38,82,44,38,.537,12,5,7,12,5,7,12,5,7,2014
Steve Clifford,CHA,1,1,82,43,39,82,43,39,82,43,39,.524,4,0,4,4,0,4,4,0,4,2014
Tom Thibodeau,CHI,4,4,82,48,34,312,205,107,312,205,107,.657,5,1,4,39,17,22,39,17,22,2014
Mike Brown,CLE,6,8,82,33,49,492,305,187,563,347,216,.616,,,,71,42,29,83,47,36,2014
Rick Carlisle,DAL,6,12,82,49,33,476,288,188,968,569,399,.588,7,3,4,48,26,22,110,56,54,2014
Brian Shaw,DEN,1,1,82,36,46,82,36,46,82,36,46,.439,,,,,,,,,,2014
Maurice Cheeks,DET,1,9,50,21,29,50,21,29,620,305,315,.492,,,,,,,16,5,11,2014
John Loyer,DET,1,1,32,8,24,32,8,24,32,8,24,.250,,,,,,,,,,2014
Mark Jackson,GSW,3,3,82,51,31,230,121,109,230,121,109,.526,7,3,4,19,9,10,19,9,10,2014
Kevin McHale,HOU,3,5,82,54,28,230,133,97,324,172,152,.531,6,2,4,12,4,8,12,4,8,2014
Frank Vogel,IND,4,4,82,56,26,267,167,100,267,167,100,.625,19,10,9,54,28,26,54,28,26,2014
Doc Rivers,LAC,1,15,82,57,25,82,57,25,1142,644,498,.564,13,6,7,13,6,7,134,70,64,2014
Mike D'Antoni,LAL,2,12,82,27,55,154,67,87,881,455,426,.516,,,,4,0,4,59,26,33,2014
Dave Joerger,MEM,1,1,82,50,32,82,50,32,82,50,32,.610,7,3,4,7,3,4,7,3,4,2014
Erik Spoelstra,MIA,6,6,82,54,28,476,314,162,476,314,162,.660,20,13,7,99,63,36,99,63,36,2014
Larry Drew,MIL,1,4,82,15,67,82,15,67,312,143,169,.458,,,,,,,24,10,14,2014
Rick Adelman,MIN,3,23,82,40,42,230,97,133,1791,1042,749,.582,,,,,,,157,79,78,2014
Monty Williams,NOP,4,4,82,34,48,312,128,184,312,128,184,.410,,,,6,2,4,6,2,4,2014
Mike Woodson,NYK,3,9,82,37,45,188,109,79,680,315,365,.463,,,,17,7,10,46,18,28,2014
Scott Brooks,OKC,6,6,82,59,23,463,293,170,463,293,170,.633,19,10,9,73,39,34,73,39,34,2014
Jacque Vaughn,ORL,2,2,82,23,59,164,43,121,164,43,121,.262,,,,,,,,,,2014
Brett Brown,PHI,1,1,82,19,63,82,19,63,82,19,63,.232,,,,,,,,,,2014
Jeff Hornacek,PHO,1,1,82,48,34,82,48,34,82,48,34,.585,,,,,,,,,,2014
Terry Stotts,POR,2,6,82,54,28,164,87,77,447,202,245,.452,11,5,6,11,5,6,16,6,10,2014
Mike Malone,SAC,1,1,82,28,54,82,28,54,82,28,54,.341,,,,,,,,,,2014
Gregg Popovich,SAS,18,18,82,62,20,1410,967,443,1410,967,443,.686,23,16,7,239,149,90,239,149,90,2014
Dwane Casey,TOR,3,5,82,48,34,230,105,125,352,158,194,.449,7,3,4,7,3,4,7,3,4,2014
Tyrone Corbin,UTA,4,4,82,25,57,258,112,146,258,112,146,.434,,,,4,0,4,4,0,4,2014
Randy Wittman,WAS,3,8,82,44,38,213,91,122,520,191,329,.367,11,6,5,11,6,5,11,6,5,2014
Mike Budenholzer,ATL,2,2,82,60,22,164,98,66,164,98,66,.598,16,8,8,23,11,12,23,11,12,2015
Brad Stevens,BOS,2,2,82,40,42,164,65,99,164,65,99,.396,4,0,4,4,0,4,4,0,4,2015
Lionel Hollins,BRK,1,8,82,38,44,82,38,44,497,252,245,.507,6,2,4,6,2,4,41,20,21,2015
Tom Thibodeau,CHI,5,5,82,50,32,394,255,139,394,255,139,.647,12,6,6,51,23,28,51,23,28,2015
Steve Clifford,CHO,2,2,82,33,49,164,76,88,164,76,88,.463,,,,4,0,4,4,0,4,2015
David Blatt,CLE,1,1,82,53,29,82,53,29,82,53,29,.646,20,14,6,20,14,6,20,14,6,2015
Rick Carlisle,DAL,7,13,82,50,32,558,338,220,1050,619,431,.590,5,1,4,53,27,26,115,57,58,2015
Brian Shaw,DEN,2,2,59,20,39,141,56,85,141,56,85,.397,,,,,,,,,,2015
Melvin Hunt,DEN,1,1,23,10,13,23,10,13,23,10,13,.435,,,,,,,,,,2015
Stan Van Gundy,DET,1,9,82,32,50,82,32,50,661,403,258,.610,,,,,,,87,48,39,2015
Steve Kerr,GSW,1,1,82,67,15,82,67,15,82,67,15,.817,21,16,5,21,16,5,21,16,5,2015
Kevin McHale,HOU,4,6,82,56,26,312,189,123,406,228,178,.562,17,9,8,29,13,16,29,13,16,2015
Frank Vogel,IND,5,5,82,38,44,349,205,144,349,205,144,.587,,,,54,28,26,54,28,26,2015
Doc Rivers,LAC,2,16,82,56,26,164,113,51,1224,700,524,.572,14,7,7,27,13,14,148,77,71,2015
Byron Scott,LAL,1,14,82,21,61,82,21,61,1019,437,582,.429,,,,,,,57,33,24,2015
Dave Joerger,MEM,2,2,82,55,27,164,105,59,164,105,59,.640,11,6,5,18,9,9,18,9,9,2015
Erik Spoelstra,MIA,7,7,82,37,45,558,351,207,558,351,207,.629,,,,99,63,36,99,63,36,2015
Jason Kidd,MIL,1,2,82,41,41,82,41,41,164,85,79,.518,6,2,4,6,2,4,18,7,11,2015
Flip Saunders,MIN,11,17,82,16,66,819,427,392,1246,654,592,.525,,,,47,17,30,98,47,51,2015
Monty Williams,NOP,5,5,82,45,37,394,173,221,394,173,221,.439,4,0,4,10,2,8,10,2,8,2015
Derek Fisher,NYK,1,1,82,17,65,82,17,65,82,17,65,.207,,,,,,,,,,2015
Scott Brooks,OKC,7,7,82,45,37,545,338,207,545,338,207,.620,,,,73,39,34,73,39,34,2015
Jacque Vaughn,ORL,3,3,52,15,37,216,58,158,216,58,158,.269,,,,,,,,,,2015
James Borrego,ORL,1,1,30,10,20,30,10,20,30,10,20,.333,,,,,,,,,,2015
Brett Brown,PHI,2,2,82,18,64,164,37,127,164,37,127,.226,,,,,,,,,,2015
Jeff Hornacek,PHO,2,2,82,39,43,164,87,77,164,87,77,.530,,,,,,,,,,2015
Terry Stotts,POR,3,7,82,51,31,246,138,108,529,253,276,.478,5,1,4,16,6,10,21,7,14,2015
Mike Malone,SAC,2,2,24,11,13,106,39,67,106,39,67,.368,,,,,,,,,,2015
Tyrone Corbin,SAC,1,5,28,7,21,28,7,21,286,119,167,.416,,,,,,,4,0,4,2015
George Karl,SAC,1,26,30,11,19,30,11,19,1917,1142,775,.596,,,,,,,185,80,105,2015
Gregg Popovich,SAS,19,19,82,55,27,1492,1022,470,1492,1022,470,.685,7,3,4,246,152,94,246,152,94,2015
Dwane Casey,TOR,4,6,82,49,33,312,154,158,434,207,227,.477,4,0,4,11,3,8,11,3,8,2015
Quin Snyder,UTA,1,1,82,38,44,82,38,44,82,38,44,.463,,,,,,,,,,2015
Randy Wittman,WAS,4,9,82,46,36,295,137,158,602,237,365,.394,10,6,4,21,12,9,21,12,9,2015
Mike Budenholzer,ATL,3,3,82,48,34,246,146,100,246,146,100,.593,10,4,6,33,15,18,33,15,18,2016
Brad Stevens,BOS,3,3,82,48,34,246,113,133,246,113,133,.459,6,2,4,10,2,8,10,2,8,2016
Lionel Hollins,BRK,2,9,37,10,27,119,48,71,534,262,272,.491,,,,6,2,4,41,20,21,2016
Tony Brown,BRK,1,1,45,11,34,45,11,34,45,11,34,.244,,,,,,,,,,2016
Fred Hoiberg,CHI,1,1,82,42,40,82,42,40,82,42,40,.512,,,,,,,,,,2016
Steve Clifford,CHO,3,3,82,48,34,246,124,122,246,124,122,.504,7,3,4,11,3,8,11,3,8,2016
David Blatt,CLE,2,2,41,30,11,123,83,40,123,83,40,.675,,,,20,14,6,20,14,6,2016
Tyronn Lue,CLE,1,1,41,27,14,41,27,14,41,27,14,.659,21,16,5,21,16,5,21,16,5,2016
Rick Carlisle,DAL,8,14,82,42,40,640,380,260,1132,661,471,.584,5,1,4,58,28,30,120,58,62,2016
Mike Malone,DEN,1,3,82,33,49,82,33,49,188,72,116,.383,,,,,,,,,,2016
Stan Van Gundy,DET,2,10,82,44,38,164,76,88,743,447,296,.602,4,0,4,4,0,4,91,48,43,2016
Steve Kerr,GSW,2,2,82,73,9,164,140,24,164,140,24,.854,24,15,9,45,31,14,45,31,14,2016
Kevin McHale,HOU,5,7,11,4,7,323,193,130,417,232,185,.556,,,,29,13,16,29,13,16,2016
J.B. Bickerstaff,HOU,1,1,71,37,34,71,37,34,71,37,34,.521,5,1,4,5,1,4,5,1,4,2016
Frank Vogel,IND,6,6,82,45,37,431,250,181,431,250,181,.580,7,3,4,61,31,30,61,31,30,2016
Doc Rivers,LAC,3,17,82,53,29,246,166,80,1306,753,553,.577,6,2,4,33,15,18,154,79,75,2016
Byron Scott,LAL,2,15,82,17,65,164,38,126,1101,454,647,.412,,,,,,,57,33,24,2016
Dave Joerger,MEM,3,3,82,42,40,246,147,99,246,147,99,.598,4,0,4,22,9,13,22,9,13,2016
Erik Spoelstra,MIA,8,8,82,48,34,640,399,241,640,399,241,.623,14,7,7,113,70,43,113,70,43,2016
Jason Kidd,MIL,2,3,82,33,49,164,74,90,246,118,128,.480,,,,6,2,4,18,7,11,2016
Sam Mitchell,MIN,1,6,82,29,53,82,29,53,427,185,242,.433,,,,,,,11,3,8,2016
Alvin Gentry,NOP,1,13,82,30,52,82,30,52,787,365,422,.464,,,,,,,21,12,9,2016
Derek Fisher,NYK,2,2,54,23,31,136,40,96,136,40,96,.294,,,,,,,,,,2016
Kurt Rambis,NYK,1,4,28,9,19,28,9,19,229,65,164,.284,,,,,,,8,3,5,2016
Billy Donovan,OKC,1,1,82,55,27,82,55,27,82,55,27,.671,18,11,7,18,11,7,18,11,7,2016
Scott Skiles,ORL,1,14,82,35,47,82,35,47,958,478,480,.499,,,,,,,42,18,24,2016
Brett Brown,PHI,3,3,82,10,72,246,47,199,246,47,199,.191,,,,,,,,,,2016
Jeff Hornacek,PHO,3,3,49,14,35,213,101,112,213,101,112,.474,,,,,,,,,,2016
Earl Watson,PHO,1,1,33,9,24,33,9,24,33,9,24,.273,,,,,,,,,,2016
Terry Stotts,POR,4,8,82,44,38,328,182,146,611,297,314,.486,11,5,6,27,11,16,32,12,20,2016
George Karl,SAC,2,27,82,33,49,112,44,68,1999,1175,824,.588,,,,,,,185,80,105,2016
Gregg Popovich,SAS,20,20,82,67,15,1574,1089,485,1574,1089,485,.692,10,6,4,256,158,98,256,158,98,2016
Dwane Casey,TOR,5,7,82,56,26,394,210,184,516,263,253,.510,20,10,10,31,13,18,31,13,18,2016
Quin Snyder,UTA,2,2,82,40,42,164,78,86,164,78,86,.476,,,,,,,,,,2016
Randy Wittman,WAS,5,10,82,41,41,377,178,199,684,278,406,.406,,,,21,12,9,21,12,9,2016
Mike Budenholzer,ATL,4,4,82,43,39,328,189,139,328,189,139,.576,6,2,4,39,17,22,39,17,22,2017
Brad Stevens,BOS,4,4,82,53,29,328,166,162,328,166,162,.506,18,9,9,28,11,17,28,11,17,2017
Kenny Atkinson,BRK,1,1,82,20,62,82,20,62,82,20,62,.244,,,,,,,,,,2017
Fred Hoiberg,CHI,2,2,82,41,41,164,83,81,164,83,81,.506,6,2,4,6,2,4,6,2,4,2017
Steve Clifford,CHO,4,4,82,36,46,328,160,168,328,160,168,.488,,,,11,3,8,11,3,8,2017
Tyronn Lue,CLE,2,2,82,51,31,123,78,45,123,78,45,.634,18,13,5,39,29,10,39,29,10,2017
Rick Carlisle,DAL,9,15,82,33,49,722,413,309,1214,694,520,.572,,,,58,28,30,120,58,62,2017
Mike Malone,DEN,2,4,82,40,42,164,73,91,270,112,158,.415,,,,,,,,,,2017
Stan Van Gundy,DET,3,11,82,37,45,246,113,133,825,484,341,.587,,,,4,0,4,91,48,43,2017
Steve Kerr,GSW,3,3,82,67,15,246,207,39,246,207,39,.841,17,16,1,62,47,15,62,47,15,2017
Mike D'Antoni,HOU,1,13,82,55,27,82,55,27,963,510,453,.530,11,6,5,11,6,5,70,32,38,2017
Nate McMillan,IND,1,13,82,42,40,82,42,40,1012,520,492,.514,4,0,4,4,0,4,38,14,24,2017
Doc Rivers,LAC,4,18,82,51,31,328,217,111,1388,804,584,.579,7,3,4,40,18,22,161,82,79,2017
Luke Walton,LAL,1,1,82,26,56,82,26,56,82,26,56,.317,,,,,,,,,,2017
David Fizdale,MEM,1,1,82,43,39,82,43,39,82,43,39,.524,6,2,4,6,2,4,6,2,4,2017
Erik Spoelstra,MIA,9,9,82,41,41,722,440,282,722,440,282,.609,,,,113,70,43,113,70,43,2017
Jason Kidd,MIL,3,4,82,42,40,246,116,130,328,160,168,.488,6,2,4,12,4,8,24,9,15,2017
Tom Thibodeau,MIN,1,6,82,31,51,82,31,51,476,286,190,.601,,,,,,,51,23,28,2017
Alvin Gentry,NOP,2,14,82,34,48,164,64,100,869,399,470,.459,,,,,,,21,12,9,2017
Jeff Hornacek,NYK,1,4,82,31,51,82,31,51,295,132,163,.447,,,,,,,,,,2017
Billy Donovan,OKC,2,2,82,47,35,164,102,62,164,102,62,.622,5,1,4,23,12,11,23,12,11,2017
Frank Vogel,ORL,1,7,82,29,53,82,29,53,513,279,234,.544,,,,,,,61,31,30,2017
Brett Brown,PHI,4,4,82,28,54,328,75,253,328,75,253,.229,,,,,,,,,,2017
Earl Watson,PHO,2,2,82,24,58,115,33,82,115,33,82,.287,,,,,,,,,,2017
Terry Stotts,POR,5,9,82,41,41,410,223,187,693,338,355,.488,4,0,4,31,11,20,36,12,24,2017
Dave Joerger,SAC,1,4,82,32,50,82,32,50,328,179,149,.546,,,,,,,22,9,13,2017
Gregg Popovich,SAS,21,21,82,61,21,1656,1150,506,1656,1150,506,.694,16,8,8,272,166,106,272,166,106,2017
Dwane Casey,TOR,6,8,82,51,31,476,261,215,598,314,284,.525,10,4,6,41,17,24,41,17,24,2017
Quin Snyder,UTA,3,3,82,51,31,246,129,117,246,129,117,.524,11,4,7,11,4,7,11,4,7,2017
Scott Brooks,WAS,1,8,82,49,33,82,49,33,627,387,240,.617,13,7,6,13,7,6,86,46,40,2017
Mike Budenholzer,ATL,5,5,82,24,58,410,213,197,410,213,197,.520,,,,39,17,22,39,17,22,2018
Brad Stevens,BOS,5,5,82,55,27,410,221,189,410,221,189,.539,19,11,8,47,22,25,47,22,25,2018
Kenny Atkinson,BRK,2,2,82,28,54,164,48,116,164,48,116,.293,,,,,,,,,,2018
Fred Hoiberg,CHI,3,3,82,27,55,246,110,136,246,110,136,.447,,,,6,2,4,6,2,4,2018
Steve Clifford,CHO,5,5,82,36,46,410,196,214,410,196,214,.478,,,,11,3,8,11,3,8,2018
Tyronn Lue,CLE,3,3,82,50,32,205,128,77,205,128,77,.624,22,12,10,61,41,20,61,41,20,2018
Rick Carlisle,DAL,10,16,82,24,58,804,437,367,1296,718,578,.554,,,,58,28,30,120,58,62,2018
Mike Malone,DEN,3,5,82,46,36,246,119,127,352,158,194,.449,,,,,,,,,,2018
Stan Van Gundy,DET,4,12,82,39,43,328,152,176,907,523,384,.577,,,,4,0,4,91,48,43,2018
Steve Kerr,GSW,4,4,82,58,24,328,265,63,328,265,63,.808,21,16,5,83,63,20,83,63,20,2018
Mike D'Antoni,HOU,2,14,82,65,17,164,120,44,1045,575,470,.550,17,11,6,28,17,11,87,43,44,2018
Nate McMillan,IND,2,14,82,48,34,164,90,74,1094,568,526,.519,7,3,4,11,3,8,45,17,28,2018
Doc Rivers,LAC,5,19,82,42,40,410,259,151,1470,846,624,.576,,,,40,18,22,161,82,79,2018
Luke Walton,LAL,2,2,82,35,47,164,61,103,164,61,103,.372,,,,,,,,,,2018
David Fizdale,MEM,2,2,19,7,12,101,50,51,101,50,51,.495,,,,6,2,4,6,2,4,2018
J.B. Bickerstaff,MEM,1,2,63,15,48,63,15,48,134,52,82,.388,,,,,,,5,1,4,2018
Erik Spoelstra,MIA,10,10,82,44,38,804,484,320,804,484,320,.602,5,1,4,118,71,47,118,71,47,2018
Jason Kidd,MIL,4,5,45,23,22,291,139,152,373,183,190,.491,,,,12,4,8,24,9,15,2018
Joe Prunty,MIL,1,1,37,21,16,37,21,16,37,21,16,.568,7,3,4,7,3,4,7,3,4,2018
Tom Thibodeau,MIN,2,7,82,47,35,164,78,86,558,333,225,.597,5,1,4,5,1,4,56,24,32,2018
Alvin Gentry,NOP,3,15,82,48,34,246,112,134,951,447,504,.470,9,5,4,9,5,4,30,17,13,2018
Jeff Hornacek,NYK,2,5,82,29,53,164,60,104,377,161,216,.427,,,,,,,,,,2018
Billy Donovan,OKC,3,3,82,48,34,246,150,96,246,150,96,.610,6,2,4,29,14,15,29,14,15,2018
Frank Vogel,ORL,2,8,82,25,57,164,54,110,595,304,291,.511,,,,,,,61,31,30,2018
Brett Brown,PHI,5,5,82,52,30,410,127,283,410,127,283,.310,10,5,5,10,5,5,10,5,5,2018
Earl Watson,PHO,3,3,3,0,3,118,33,85,118,33,85,.280,,,,,,,,,,2018
Jay Triano,PHO,1,4,79,21,58,79,21,58,308,108,200,.351,,,,,,,,,,2018
Terry Stotts,POR,6,10,82,49,33,492,272,220,775,387,388,.499,4,0,4,35,11,24,40,12,28,2018
Dave Joerger,SAC,2,5,82,27,55,164,59,105,410,206,204,.502,,,,,,,22,9,13,2018
Gregg Popovich,SAS,22,22,82,47,35,1738,1197,541,1738,1197,541,.689,5,1,4,277,167,110,277,167,110,2018
Dwane Casey,TOR,7,9,82,59,23,558,320,238,680,373,307,.549,10,4,6,51,21,30,51,21,30,2018
Quin Snyder,UTA,4,4,82,48,34,328,177,151,328,177,151,.540,11,5,6,22,9,13,22,9,13,2018
Scott Brooks,WAS,2,9,82,43,39,164,92,72,709,430,279,.606,6,2,4,19,9,10,92,48,44,2018
Lloyd Pierce,ATL,1,1,82,29,53,82,29,53,82,29,53,.354,,,,,,,,,,2019
Brad Stevens,BOS,6,6,82,49,33,492,270,222,492,270,222,.549,9,5,4,56,27,29,56,27,29,2019
Kenny Atkinson,BRK,3,3,82,42,40,246,90,156,246,90,156,.366,5,1,4,5,1,4,5,1,4,2019
Fred Hoiberg,CHI,4,4,24,5,19,270,115,155,270,115,155,.426,,,,6,2,4,6,2,4,2019
Jim Boylen,CHI,1,1,58,17,41,58,17,41,58,17,41,.293,,,,,,,,,,2019
James Borrego,CHO,1,2,82,39,43,82,39,43,112,49,63,.438,,,,,,,,,,2019
Tyronn Lue,CLE,4,4,6,0,6,211,128,83,211,128,83,.607,,,,61,41,20,61,41,20,2019
Larry Drew,CLE,1,5,76,19,57,76,19,57,388,162,226,.418,,,,,,,24,10,14,2019
Rick Carlisle,DAL,11,17,82,33,49,886,470,416,1378,751,627,.545,,,,58,28,30,120,58,62,2019
Mike Malone,DEN,4,6,82,54,28,328,173,155,434,212,222,.488,14,7,7,14,7,7,14,7,7,2019
Dwane Casey,DET,1,10,82,41,41,82,41,41,762,414,348,.543,4,0,4,4,0,4,55,21,34,2019
Steve Kerr,GSW,5,5,82,57,25,410,322,88,410,322,88,.785,22,14,8,105,77,28,105,77,28,2019
Mike D'Antoni,HOU,3,15,82,53,29,246,173,73,1127,628,499,.557,11,6,5,39,23,16,98,49,49,2019
Nate McMillan,IND,3,15,82,48,34,246,138,108,1176,616,560,.524,4,0,4,15,3,12,49,17,32,2019
Doc Rivers,LAC,6,20,82,48,34,492,307,185,1552,894,658,.576,6,2,4,46,20,26,167,84,83,2019
Luke Walton,LAL,3,3,82,37,45,246,98,148,246,98,148,.398,,,,,,,,,,2019
J.B. Bickerstaff,MEM,2,3,82,33,49,145,48,97,216,85,131,.394,,,,,,,5,1,4,2019
Erik Spoelstra,MIA,11,11,82,39,43,886,523,363,886,523,363,.590,,,,118,71,47,118,71,47,2019
Mike Budenholzer,MIL,1,6,82,60,22,82,60,22,492,273,219,.555,15,10,5,15,10,5,54,27,27,2019
Tom Thibodeau,MIN,3,8,40,19,21,204,97,107,598,352,246,.589,,,,5,1,4,56,24,32,2019
Ryan Saunders,MIN,1,1,42,17,25,42,17,25,42,17,25,.405,,,,,,,,,,2019
Alvin Gentry,NOP,4,16,82,33,49,328,145,183,1033,480,553,.465,,,,9,5,4,30,17,13,2019
David Fizdale,NYK,1,3,82,17,65,82,17,65,183,67,116,.366,,,,,,,6,2,4,2019
Billy Donovan,OKC,4,4,82,49,33,328,199,129,328,199,129,.607,5,1,4,34,15,19,34,15,19,2019
Steve Clifford,ORL,1,6,82,42,40,82,42,40,492,238,254,.484,5,1,4,5,1,4,16,4,12,2019
Brett Brown,PHI,6,6,82,51,31,492,178,314,492,178,314,.362,12,7,5,22,12,10,22,12,10,2019
Igor Kokoskov,PHO,1,1,82,19,63,82,19,63,82,19,63,.232,,,,,,,,,,2019
Terry Stotts,POR,7,11,82,53,29,574,325,249,857,440,417,.513,16,8,8,51,19,32,56,20,36,2019
Dave Joerger,SAC,3,6,82,39,43,246,98,148,492,245,247,.498,,,,,,,22,9,13,2019
Gregg Popovich,SAS,23,23,82,48,34,1820,1245,575,1820,1245,575,.684,7,3,4,284,170,114,284,170,114,2019
Nick Nurse,TOR,1,1,82,58,24,82,58,24,82,58,24,.707,24,16,8,24,16,8,24,16,8,2019
Quin Snyder,UTA,5,5,82,50,32,410,227,183,410,227,183,.554,5,1,4,27,10,17,27,10,17,2019
Scott Brooks,WAS,3,10,82,32,50,246,124,122,791,462,329,.584,,,,19,9,10,92,48,44,2019
